x a x x x a x
1 1 2 2 2 3 3
1 1 4 4 4 3 3
2 2 4 4 4 5 5
2 2 4 4 4 5 5
1 3 3 2 1 1 2
1 3 3 2 1 1 2
_ _ _ _ _ _ _
11