x 1 a 1 x
a 1 a 1 a
2 3 a 3 2
2 3 2 3 2
3 1 2 1 3
3 1 2 1 3
1 3 2 3 1
1 3 2 3 1
_ _ _ _ _