x x a 0 a 0 a
x x 1 2 3 2 3
x x 1 2 3 2 3
x x 2 3 1 2 1
3 3 2 3 1 2 1
3 1 3 1 3 1 3
1 1 3 1 3 1 3
3 2 2 3 2 / /
1 3 2 3 2 / /
_ _ _ _ _ _ _
11