x x x x a a a a
x x x 1 1 2 1 3
x x 1 3 1 2 1 3
x 1 1 3 2 3 2 2
3 2 3 2 2 3 2 /
2 2 3 2 1 3 / /
3 3 1 3 1 / / /
1 3 1 3 / / / /
_ _ _ _ _ _ _ _
30