x a a x x
x 1 2 x x
x 3 2 x x
x 1 2 x x
2 2 2 2 2
2 2 2 2 2
2 2 2 2 2
2 2 2 2 2
2 2 2 2 2
_ _ _ _ _
11