1 1 1 2 a 1 1 / 3
1 1 2 a 2 2 1 / 3
1 2 a 1 3 3 a / 4
2 / / / / / / / 4
a / x / 4 3 4 3 3
1 / x / 3 4 4 3 3
a / x / 3 3 4 3 3
1 / x / 3 4 4 4 3
2 / x / 4 3 4 3 4
_ _ _ _ _ _ _ _ _